0 3 1 1 1 4 0 0 0 2 4 0 0 3 7
3 0 1 1 3 3 0 3 2 0 0 4 0 1 3
0 3 1 1 1 4 0 0 3 0 4 0 0 3 7
3 0 3 2 3 2 0 0 2 7 0 4 0 1 3
0 3 1 2 1 0 0 0 3 7 4 0 0 3 7
3 0 3 2 3 0 0 0 2 7 0 4 0 1 3
0 3 1 1 1 0 0 3 0 0 4 0 0 3 7
3 0 1 1 3 2 2 0 3 1 0 4 0 1 3

0 0 0 0 0 0 0 0 0 0 0 0 0 0 0
0 0 0 0 0 0 0 0 0 0 0 0 0 0 0
0 0 0 0 0 0 0 0 0 1 0 1 0 0 0
0 0 0 0 0 0 0 0 0 0 0 0 0 0 0
0 0 0 0 0 2 0 0 0 0 0 0 0 0 0
0 0 0 0 0 2 0 0 0 1 0 0 0 0 0
0 0 0 0 0 2 0 0 0 0 0 1 0 0 0
0 0 0 0 0 0 0 0 0 0 0 0 0 0 0