0 3 0 2 4 2 4 2 4 2 0 2 0 2 1
3 0 0 3 0 3 0 3 0 3 0 1 0 1 0
0 3 0 2 4 2 4 2 4 3 0 0 1 0 4
3 0 0 0 2 2 2 0 3 4 3 1 0 1 0
0 3 0 2 0 5 0 2 0 3 1 0 1 0 1
3 0 3 2 5 5 5 2 0 1 0 1 0 1 0
0 3 0 2 0 5 0 2 1 0 1 0 1 0 1
3 0 3 0 2 2 2 1 0 1 0 1 0 1 0