0 3 1 1 1 4 0 0 0 2 4 0 0 0 6
3 0 1 1 3 3 0 3 0 0 0 4 0 6 0
0 3 1 1 1 4 0 0 0 0 4 0 0 0 6
3 0 1 1 3 2 0 0 0 0 0 4 0 6 0
0 3 1 1 1 4 0 0 0 0 4 0 0 0 6
3 0 1 1 3 5 0 0 0 0 0 4 0 6 0
0 3 1 1 1 4 0 0 0 0 4 0 0 0 6
3 0 1 1 3 2 2 0 0 1 0 4 0 6 0

0 0 0 0 0 0 0 0 0 0 0 2 0 0 0
0 0 0 0 0 0 0 0 0 0 0 0 0 0 0
0 0 0 0 0 0 0 0 0 0 0 2 0 0 0
0 0 0 0 0 0 0 0 0 0 0 0 0 0 0
0 0 0 0 0 0 0 0 0 0 0 2 0 0 0
0 0 0 0 0 0 0 0 0 0 0 0 0 0 0
0 0 0 0 0 0 0 0 0 0 0 2 0 0 0
0 0 0 0 0 0 0 0 0 0 0 0 0 0 0